15 15
010001100011111
100011011100111
011000011110011
110111101101100
110100101111111
001101110100101
001101110100101
011110011111111
001101101111101
110001101100000
001111100011110
010011111011110
